|---------------------------------------------------------------------------------------|
|                                                                                       |
|  |--------------------|                                                               |
|  |                    |                                                               |
|  |                    |   |--------------------|     |-----------------------------|  |
|  |                    |   |                    |     |                             |  |
|  |                    |   |                    |     |                             |  |
|  |--            ------|   |                    |     |                             |  |
|     |           |         |                    |     |                             |  |
|     |           |---------|              ------|     |                             |  |
|     |                                     |          |                             |  |
|     |                                     |          |                             |  |
|     |-------------|       |---------------|          |-----------|      |----------|  |
|                   |       |                                      |      |             |
|     |-------------|       |-------------|                        |      |             |
|     |                                   |                        |      |             |
|     |                                   |---------------|        |      |             |
|     |                                                   |        |      |             |
|     |                                                   |        |      |             |
|     |                                   |--------|      |        |      |             |
|     |                                   |        |      |--------|      |             |
|     |-----------------------------------|        |                      |             |
|                                                  |                      |             |
|                                                  |      |---------------|             |
|                                                  |      |                             |
|                                                                                       |
|---------------------------------------------------------------------------------------|