|---------------------------------------------------------------------------------------|
|.......................................................................................|
|..|--------------------|...............................................................|
|..|                    |...............................................................|
|..|                    |...|--------------------|.....|-----------------------------|..|
|..|                    |...|                    |.....|                             |..|
|..|                    |...|                    |.....|                             |..|
|..|---           ------|...|                    |.....|                             |..|
|.....|           |.........|                    |.....|                             |..|
|.....|           |---------|               -----|.....|                             |..|
|.....|                                     |..........|                             |..|
|.....|                                     |..........|                             |..|
|.....|-------------|       |---------------|..........|-----------|      |----------|..|
|...................|       |......................................|      |.............|
|.....|-------------|       |-------------|........................|      |.............|
|.....|                                   |........................|      |.............|
|.....|                                   |---------------|........|      |.............|
|.....|                                                   |........|      |.............|
|.....|                                                   |........|      |.............|
|.....|                                   |--------|      |........|      |.............|
|.....|                                   |........|      |--------|      |.............|
|.....|-----------------------------------|........|                      |.............|
|..................................................|                      |.............|
|..................................................|      |---------------|.............|
|..................................................|      |.............................|
|..................................................|      |.............................|
|---------------------------------------------------------------------------------------|
